STATE/UT,Year,Rape,Kidnapping and Abduction,Dowry Deaths,Assault on women with intent to outrage her modesty,Insult to modesty of Women,Cruelty by Husband or his Relatives,Importation of Girls,Total Crimes,Males,Females,Persons,Latitude,Longitude,Total Crimes Weigt,Cardinal Direction,Crime Weight Per Population
ANDHRA PRADESH,2001,871,765,420,3544,2271,5791,7,13669,38527000,37683000,76210000,14.7504291,78.57002559,68991,S,0.0009052748983073087
ANDHRA PRADESH,2002,1002,854,449,3799,2024,7018,0,15146,38976000,38179000,77155000,14.7504291,78.57002559,76426,S,0.0009905514872658933
ANDHRA PRADESH,2003,946,931,466,4128,2286,8167,5,16929,39414000,38660000,78074000,14.7504291,78.57002559,82539,S,0.0010571893331967107
ANDHRA PRADESH,2004,1016,1030,512,3817,2310,8388,2,17075,39844000,39129000,78973000,14.7504291,78.57002559,84419,S,0.0010689602775632177
ANDHRA PRADESH,2005,935,995,443,3595,2508,8696,3,17175,40264000,39587000,79851000,14.7504291,78.57002559,82237,S,0.0010298806527156829
ANDHRA PRADESH,2006,1049,1329,519,4534,2411,9164,0,19006,40677000,40036000,80713000,14.7504291,78.57002559,94205,S,0.001167160184852502
ANDHRA PRADESH,2007,1070,1564,613,4406,3316,11335,0,22304,41080000,40474000,81554000,14.7504291,78.57002559,106868,S,0.0013103955661279644
ANDHRA PRADESH,2008,1257,1396,556,4730,3551,10306,0,21796,41475000,40900000,82375000,14.7504291,78.57002559,106376,S,0.0012913626707132019
ANDHRA PRADESH,2009,1188,1526,546,5147,3520,11297,0,23224,41862000,41316000,83178000,14.7504291,78.57002559,111456,S,0.0013399697035273751
ANDHRA PRADESH,2010,1362,1531,588,4634,4562,12080,0,24757,42240000,41724000,83964000,14.7504291,78.57002559,117656,S,0.0014012672097565623
ANDHRA PRADESH,2011,1442,1612,599,4849,3658,13376,0,25536,42611000,42124000,84735000,14.7504291,78.57002559,122082,S,0.001440750575323066
ANDHRA PRADESH,2012,1341,1403,504,4816,3714,13389,0,25167,42974000,42517000,85491000,14.7504291,78.57002559,117094,S,0.0013696646430618427
ANDHRA PRADESH,2013,1635,1595,492,6930,4702,15084,0,30438,43329000,42901000,86230000,14.7504291,78.57002559,141863,S,0.0016451698944682826
ANDHRA PRADESH,2014,1940,1432,504,7735,3791,12731,0,28133,43676000,43277000,86953000,14.7504291,78.57002559,139221,S,0.0016011063448069646
ARUNACHAL PRADESH,2001,33,55,0,78,3,11,0,180,580000,518000,1098000,27.10039878,93.61660071,1477,NE,0.0013451730418943533
ARUNACHAL PRADESH,2002,38,38,0,68,2,13,0,159,587000,525000,1112000,27.10039878,93.61660071,1335,NE,0.0012005395683453237
ARUNACHAL PRADESH,2003,31,51,0,43,0,14,0,139,595000,532000,1127000,27.10039878,93.61660071,1232,NE,0.001093167701863354
ARUNACHAL PRADESH,2004,42,41,0,61,0,4,0,148,602000,539000,1141000,27.10039878,93.61660071,1357,NE,0.001189307624890447
ARUNACHAL PRADESH,2005,35,39,0,67,0,9,0,150,609000,546000,1155000,27.10039878,93.61660071,1277,NE,0.0011056277056277057
ARUNACHAL PRADESH,2006,37,51,1,63,2,14,0,168,617000,553000,1170000,27.10039878,93.61660071,1443,NE,0.0012333333333333332
ARUNACHAL PRADESH,2007,48,44,0,72,1,20,0,185,624000,560000,1184000,27.10039878,93.61660071,1583,NE,0.0013369932432432433
ARUNACHAL PRADESH,2008,42,47,0,72,1,13,0,175,631000,567000,1198000,27.10039878,93.61660071,1502,NE,0.0012537562604340567
ARUNACHAL PRADESH,2009,59,28,0,58,6,13,0,164,639000,573000,1212000,27.10039878,93.61660071,1512,NE,0.0012475247524752475
ARUNACHAL PRADESH,2010,47,46,0,84,1,12,0,190,646000,580000,1226000,27.10039878,93.61660071,1624,NE,0.0013246329526916802
ARUNACHAL PRADESH,2011,42,60,0,51,0,18,0,171,654000,587000,1241000,27.10039878,93.61660071,1539,NE,0.0012401289282836423
ARUNACHAL PRADESH,2012,46,58,1,67,2,26,0,200,661000,594000,1255000,27.10039878,93.61660071,1704,NE,0.001357768924302789
ARUNACHAL PRADESH,2013,75,86,0,93,3,29,0,286,668000,601000,1269000,27.10039878,93.61660071,2546,NE,0.0020063041765169425
ARUNACHAL PRADESH,2014,83,91,1,121,3,42,0,341,676000,608000,1284000,27.10039878,93.61660071,2910,NE,0.0022663551401869157
ASSAM,2001,817,1070,59,850,4,1248,0,4048,13777000,12878000,26655000,26.7499809,94.21666744,31846,NE,0.0011947477021196774
ASSAM,2002,970,1276,70,984,7,1694,0,5001,13981000,13090000,27071000,26.7499809,94.21666744,38383,NE,0.00141786413505227
ASSAM,2003,1095,1351,60,878,6,1808,0,5198,14181000,13298000,27479000,26.7499809,94.21666744,40667,NE,0.0014799301284617345
ASSAM,2004,1171,1552,74,883,11,1945,0,5636,14377000,13501000,27878000,26.7499809,94.21666744,44478,NE,0.0015954516105889948
ASSAM,2005,1238,1456,99,899,19,2206,3,5920,14571000,13702000,28273000,26.7499809,94.21666744,45815,NE,0.0016204506065857886
ASSAM,2006,1244,1544,105,1290,10,2548,0,6741,14763000,13902000,28665000,26.7499809,94.21666744,49799,NE,0.0017372754229897087
ASSAM,2007,1437,1471,100,789,10,3000,0,6807,14654000,14099000,28753000,26.7499809,94.21666744,50740,NE,0.001764685424129656
ASSAM,2008,1438,1789,103,1272,2,3478,0,8082,15141000,14204000,29345000,26.7499809,94.21666744,57805,NE,0.001969841540296473
ASSAM,2009,1631,2092,170,1342,10,4398,1,9644,15327000,14486000,29813000,26.7499809,94.21666744,67879,NE,0.002276825545902794
ASSAM,2010,1721,2767,175,1400,20,5410,0,11493,15512000,14678000,30190000,26.7499809,94.21666744,79400,NE,0.0026300099370652535
ASSAM,2011,1700,3192,121,1193,8,5246,2,11462,15698000,14870000,30568000,26.7499809,94.21666744,80982,NE,0.0026492410363779116
ASSAM,2012,1716,3360,140,1840,5,6407,2,13470,15883000,15061000,30944000,26.7499809,94.21666744,89896,NE,0.00290511892450879
ASSAM,2013,1937,4222,170,2409,14,8636,2,17390,16068000,15251000,31319000,26.7499809,94.21666744,111840,NE,0.00357099524250455
ASSAM,2014,1980,3895,188,3099,1,9626,1,18790,16252000,15441000,31693000,26.7499809,94.21666744,115856,NE,0.0036555706307386487
BIHAR,2001,888,518,859,562,21,1558,83,4489,43244000,39755000,82999000,25.78541445,87.4799727,39762,E,0.0004790660128435282
BIHAR,2002,1040,744,927,621,6,1577,38,4953,44065000,40548000,84613000,25.78541445,87.4799727,45179,E,0.0005339486840083675
BIHAR,2003,985,674,909,688,11,1880,37,5184,44867000,41328000,86195000,25.78541445,87.4799727,44633,E,0.0005178142583676548
BIHAR,2004,1390,997,1029,704,13,2679,35,6847,45651000,42094000,87745000,25.78541445,87.4799727,58201,E,0.0006632970539631888
BIHAR,2005,1147,929,1014,451,13,1574,74,5202,43417000,42847000,86264000,25.78541445,87.4799727,49461,E,0.000573367801168506
BIHAR,2006,1232,1084,1188,530,53,1689,42,5818,47165000,43586000,90751000,25.78541445,87.4799727,55436,E,0.0006108582825533603
BIHAR,2007,1555,1260,1172,853,12,1635,56,6543,47896000,44312000,92208000,25.78541445,87.4799727,63271,E,0.0006861769043900746
BIHAR,2008,1302,1789,1210,999,21,1992,22,7335,48608000,45025000,93633000,25.78541445,87.4799727,66824,E,0.0007136800059807974
BIHAR,2009,929,1986,1295,726,12,2532,31,7511,49303000,45724000,95027000,25.78541445,87.4799727,64792,E,0.0006818272701442748
BIHAR,2010,795,2569,1257,534,16,2271,8,7450,49980000,46409000,96389000,25.78541445,87.4799727,66081,E,0.0006855657803276307
BIHAR,2011,934,3050,1413,790,11,2607,10,8815,50640000,47080000,97720000,25.78541445,87.4799727,77609,E,0.0007941977077363896
BIHAR,2012,927,3789,1275,118,37,3686,4,9836,51282000,47738000,99020000,25.78541445,87.4799727,82719,E,0.0008353766915774591
BIHAR,2013,1128,4419,1182,331,52,4533,7,11652,51906000,48382000,100288000,25.78541445,87.4799727,94320,E,0.0009404913848117422
BIHAR,2014,1127,4735,1373,572,69,4672,5,12553,52514000,49012000,101526000,25.78541445,87.4799727,101983,E,0.0010045013100092588
CHHATTISGARH,2001,959,171,70,1763,161,840,0,3964,10474000,10360000,20834000,22.09042035,82.15998734,28963,E,0.0013901795142555438
CHHATTISGARH,2002,992,154,85,1483,147,653,0,3514,10653000,10544000,21197000,22.09042035,82.15998734,27510,E,0.0012978251639382931
CHHATTISGARH,2003,898,149,79,1481,105,601,0,3313,10829000,10725000,21554000,22.09042035,82.15998734,25668,E,0.001190869444186694
CHHATTISGARH,2004,969,174,71,1661,131,741,0,3747,11002000,10902000,21904000,22.09042035,82.15998734,28261,E,0.0012902209642074508
CHHATTISGARH,2005,990,184,100,1450,132,732,0,3588,11174000,11076000,22250000,22.09042035,82.15998734,28032,E,0.001259865168539326
CHHATTISGARH,2006,995,178,103,1598,143,717,1,3735,11345000,11249000,22594000,22.09042035,82.15998734,28830,E,0.001276002478534124
CHHATTISGARH,2007,982,181,100,1549,111,824,0,3747,11514000,11419000,22933000,22.09042035,82.15998734,28590,E,0.001246675097021759
CHHATTISGARH,2008,978,216,106,1621,125,897,0,3943,11682000,11587000,23269000,22.09042035,82.15998734,29591,E,0.0012716919506639735
CHHATTISGARH,2009,976,229,128,1598,152,893,0,3976,11848000,11753000,23601000,22.09042035,82.15998734,29975,E,0.0012700733019787298
CHHATTISGARH,2010,1012,279,115,1706,182,861,2,4157,12013000,11917000,23930000,22.09042035,82.15998734,31374,E,0.0013110739657333891
CHHATTISGARH,2011,1053,365,104,1654,174,834,2,4186,12177000,12081000,24258000,22.09042035,82.15998734,32319,E,0.0013323027454860252
CHHATTISGARH,2012,1034,350,81,1601,162,980,0,4208,12341000,12244000,24585000,22.09042035,82.15998734,31656,E,0.001287614399023795
CHHATTISGARH,2013,1380,1881,109,2261,180,1181,1,6993,12503000,12406000,24909000,22.09042035,82.15998734,56543,E,0.0022699827371632742
CHHATTISGARH,2014,1436,1393,128,2122,79,964,0,6122,12665000,12567000,25232000,22.09042035,82.15998734,51129,E,0.002026355421686747
GOA,2001,12,6,2,17,7,11,0,55,687000,660000,1347000,15.491997,73.81800065,409,W,0.000303637713437268
GOA,2002,12,5,2,18,6,8,0,51,695000,658000,1353000,15.491997,73.81800065,392,W,0.00028972653362897263
GOA,2003,31,13,2,19,7,24,0,96,710000,666000,1376000,15.491997,73.81800065,813,W,0.0005908430232558139
GOA,2004,37,10,2,23,15,17,0,104,730000,680000,1410000,15.491997,73.81800065,896,W,0.0006354609929078015
GOA,2005,20,12,2,30,8,11,0,83,752000,697000,1449000,15.491997,73.81800065,657,W,0.000453416149068323
GOA,2006,21,10,0,18,7,14,0,70,776000,716000,1492000,15.491997,73.81800065,568,W,0.0003806970509383378
GOA,2007,20,7,2,20,7,14,0,70,802000,737000,1539000,15.491997,73.81800065,563,W,0.0003658219623131904
GOA,2008,30,28,2,32,12,12,0,116,832000,763000,1595000,15.491997,73.81800065,992,W,0.0006219435736677116
GOA,2009,47,22,3,37,10,21,0,140,864000,791000,1655000,15.491997,73.81800065,1248,W,0.0007540785498489426
GOA,2010,36,18,1,36,16,17,0,124,896000,818000,1714000,15.491997,73.81800065,1014,W,0.0005915985997666278
GOA,2011,29,17,1,29,12,18,0,106,926000,841000,1767000,15.491997,73.81800065,855,W,0.0004838709677419355
GOA,2012,55,16,0,49,16,24,0,160,956000,862000,1818000,15.491997,73.81800065,1350,W,0.0007425742574257426
GOA,2013,86,70,0,162,54,40,0,412,986000,882000,1868000,15.491997,73.81800065,3082,W,0.0016498929336188437
GOA,2014,95,86,0,202,57,35,0,475,1015000,900000,1915000,15.491997,73.81800065,3571,W,0.0018647519582245431
GUJARAT,2001,286,857,67,756,111,3667,0,5744,26386000,24285000,50671000,22.2587,71.1924,28979,W,0.0005719050344378441
GUJARAT,2002,267,807,62,750,104,3321,0,5311,26872000,24684000,51556000,22.2587,71.1924,27030,W,0.0005242842734114361
GUJARAT,2003,236,859,54,722,92,3684,0,5647,27352000,25076000,52428000,22.2587,71.1924,27878,W,0.0005317387655451285
GUJARAT,2004,339,905,58,757,164,3955,0,6178,27827000,25463000,53290000,22.2587,71.1924,31147,W,0.0005844811409270032
GUJARAT,2005,324,916,48,802,104,4090,0,6284,28296000,25844000,54140000,22.2587,71.1924,31332,W,0.0005787218322866642
GUJARAT,2006,354,945,50,736,138,4977,0,7200,28760000,26220000,54980000,22.2587,71.1924,34535,W,0.000628137504547108
GUJARAT,2007,316,1089,42,822,120,5827,0,8216,29219000,26509000,55728000,22.2587,71.1924,38211,W,0.0006856696813092162
GUJARAT,2008,374,1119,27,828,122,6094,0,8564,29672000,26954000,56626000,22.2587,71.1924,39993,W,0.0007062656730123971
GUJARAT,2009,433,1162,24,727,114,5506,0,7966,30121000,27313000,57434000,22.2587,71.1924,38970,W,0.000678517951039454
GUJARAT,2010,408,1290,19,668,110,5600,0,8095,30565000,27667000,58232000,22.2587,71.1924,39775,W,0.0006830436873196868
GUJARAT,2011,439,1442,30,685,93,6052,0,8741,31005000,28016000,59021000,22.2587,71.1924,43315,W,0.0007338913268158791
GUJARAT,2012,473,1527,21,745,93,6658,0,9517,31440000,28359000,59799000,22.2587,71.1924,46658,W,0.000780247161323768
GUJARAT,2013,732,2230,29,1243,77,7812,0,12123,31871000,28698000,60569000,22.2587,71.1924,63597,W,0.0010499925704568344
GUJARAT,2014,841,2187,23,1352,173,5991,0,10567,32298000,29032000,61330000,22.2587,71.1924,60082,W,0.0009796510679928258
HARYANA,2001,398,297,285,478,401,1513,0,3372,11364000,9781000,21145000,28.45000633,77.01999101,21347,N,0.001009553085835895
HARYANA,2002,361,290,256,454,1424,1565,0,4350,11605000,9975000,21580000,28.45000633,77.01999101,23392,N,0.0010839666357738648
HARYANA,2003,353,271,222,344,1302,1618,0,4110,11846000,10169000,22015000,28.45000633,77.01999101,21815,N,0.0009909152850329321
HARYANA,2004,386,292,251,403,850,2026,0,4208,12088000,10362000,22450000,28.45000633,77.01999101,23118,N,0.0010297550111358575
HARYANA,2005,461,344,212,380,597,2075,0,4069,12329000,10555000,22884000,28.45000633,77.01999101,23451,N,0.0010247771368641846
HARYANA,2006,608,431,255,486,491,2254,0,4525,12568000,10746000,23314000,28.45000633,77.01999101,27920,N,0.001197563695633525
HARYANA,2007,488,554,269,417,409,2412,0,4549,12807000,10936000,23743000,28.45000633,77.01999101,27443,N,0.0011558354041191089
HARYANA,2008,631,644,302,435,605,2435,0,5052,13046000,11125000,24171000,28.45000633,77.01999101,31730,N,0.0013127301311488975
HARYANA,2009,603,659,281,451,605,2617,0,5216,13284000,11313000,24597000,28.45000633,77.01999101,31771,N,0.0012916615847461072
HARYANA,2010,720,714,284,476,580,2720,0,5494,13520000,11500000,25020000,28.45000633,77.01999101,34480,N,0.0013780975219824141
HARYANA,2011,733,733,255,474,490,2740,0,5425,13754000,11685000,25439000,28.45000633,77.01999101,34210,N,0.0013447855654703407
HARYANA,2012,668,900,258,525,434,3137,0,5922,13985000,11869000,25854000,28.45000633,77.01999101,36228,N,0.0014012531909955905
HARYANA,2013,971,1957,263,1560,643,3617,2,9013,14216000,12051000,26267000,28.45000633,77.01999101,58680,N,0.0022339818022613926
HARYANA,2014,1174,1922,293,1688,102,3478,0,8657,14444000,12231000,26675000,28.45000633,77.01999101,60405,N,0.0022644798500468604
HIMACHAL PRADESH,2001,124,105,10,310,14,317,0,880,3088000,2990000,6078000,31.10002545,77.16659704,5603,N,0.0009218492925304377
HIMACHAL PRADESH,2002,137,116,6,326,12,234,0,831,313000,3027000,3030000,31.10002545,77.16659704,5673,N,0.0018722772277227724
HIMACHAL PRADESH,2003,126,96,6,250,18,221,0,717,3171000,3063000,6234000,31.10002545,77.16659704,4907,N,0.000787135065768367
HIMACHAL PRADESH,2004,153,99,8,284,16,252,0,812,3211000,3098000,6309000,31.10002545,77.16659704,5629,N,0.0008922174671104771
HIMACHAL PRADESH,2005,141,102,2,286,29,228,0,788,3250000,3132000,6382000,31.10002545,77.16659704,5366,N,0.0008408022563459731
HIMACHAL PRADESH,2006,113,109,3,275,31,259,0,790,3289000,3166000,6455000,31.10002545,77.16659704,5075,N,0.0007862122385747483
HIMACHAL PRADESH,2007,159,150,8,322,33,342,0,1014,3327000,3199000,6526000,31.10002545,77.16659704,6740,N,0.0010327919092859331
HIMACHAL PRADESH,2008,157,137,3,295,41,343,0,976,3364000,3231000,6595000,31.10002545,77.16659704,6397,N,0.0009699772554965883
HIMACHAL PRADESH,2009,183,122,1,318,37,284,0,945,3400000,3262000,6662000,31.10002545,77.16659704,6533,N,0.0009806364455118583
HIMACHAL PRADESH,2010,160,162,2,350,78,275,0,1027,3436000,3293000,6729000,31.10002545,77.16659704,6859,N,0.0010193193639470948
HIMACHAL PRADESH,2011,168,191,4,331,62,239,0,995,3471000,3322000,6793000,31.10002545,77.16659704,7048,N,0.0010375386427204476
HIMACHAL PRADESH,2012,183,152,2,250,68,251,0,906,3505000,3351000,6856000,31.10002545,77.16659704,6502,N,0.0009483663943990665
HIMACHAL PRADESH,2013,250,290,0,493,111,328,0,1472,3539000,3380000,6919000,31.10002545,77.16659704,10432,N,0.001507732331261743
HIMACHAL PRADESH,2014,283,227,1,538,60,325,0,1434,3571000,3407000,6978000,31.10002545,77.16659704,10375,N,0.0014868157065061622
JAMMU & KASHMIR,2001,169,504,13,622,288,50,0,1646,5361000,4783000,10144000,34.29995933,74.46665849,11894,N,0.0011725157728706625
JAMMU & KASHMIR,2002,192,596,18,785,368,54,0,2013,5436000,4862000,10298000,34.29995933,74.46665849,14301,N,0.0013887162555836084
JAMMU & KASHMIR,2003,211,615,10,875,376,71,0,2158,5518000,4943000,10461000,34.29995933,74.46665849,15181,N,0.0014511996941019023
JAMMU & KASHMIR,2004,218,632,9,990,264,82,0,2195,5598000,5024000,10622000,34.29995933,74.46665849,15713,N,0.0014792882696290717
JAMMU & KASHMIR,2005,201,658,5,830,371,76,0,2141,5678000,5105000,10783000,34.29995933,74.46665849,15161,N,0.001406009459334137
JAMMU & KASHMIR,2006,250,723,10,960,347,135,0,2425,5756000,5185000,10941000,34.29995933,74.46665849,17376,N,0.0015881546476556074
JAMMU & KASHMIR,2007,288,707,9,986,353,176,0,2519,5834000,5265000,11099000,34.29995933,74.46665849,18042,N,0.0016255518515181549
JAMMU & KASHMIR,2008,219,656,21,935,296,162,0,2289,5912000,5345000,11257000,34.29995933,74.46665849,16209,N,0.001439904059696189
JAMMU & KASHMIR,2009,237,825,12,972,371,196,0,2613,5990000,5424000,11414000,34.29995933,74.46665849,18546,N,0.0016248466795163834
JAMMU & KASHMIR,2010,245,840,9,1038,262,211,0,2605,6066000,5502000,11568000,34.29995933,74.46665849,18819,N,0.0016268153526970955
JAMMU & KASHMIR,2011,277,1023,11,1194,350,286,0,3141,6139000,5579000,11718000,34.29995933,74.46665849,22428,N,0.0019139784946236558
JAMMU & KASHMIR,2012,303,1041,8,1322,347,301,0,3322,6211000,5654000,11865000,34.29995933,74.46665849,23629,N,0.001991487568478719
JAMMU & KASHMIR,2013,378,949,7,1389,354,428,0,3505,6282000,5728000,12010000,34.29995933,74.46665849,24556,N,0.002044629475437136
JAMMU & KASHMIR,2014,331,813,5,1421,237,467,0,3274,6350000,5801000,12151000,34.29995933,74.46665849,22387,N,0.0018423998024853921
JHARKHAND,2001,567,279,217,297,5,484,2,1851,13885000,13061000,26946000,23.80039349,86.41998572,17522,E,0.0006502634899428487
JHARKHAND,2002,797,178,275,411,3,588,36,2288,14139000,13304000,27443000,23.80039349,86.41998572,22048,E,0.0008034107058266225
JHARKHAND,2003,712,262,262,424,2,559,0,2221,14384000,13538000,27922000,23.80039349,86.41998572,21033,E,0.0007532769858892629
JHARKHAND,2004,797,178,275,411,3,588,36,2288,14622000,13766000,28388000,23.80039349,86.41998572,22048,E,0.0007766661969846413
JHARKHAND,2005,753,283,257,293,36,590,4,2216,14856000,13990000,28846000,23.80039349,86.41998572,21363,E,0.000740587949802399
JHARKHAND,2006,799,410,281,414,44,668,5,2621,15088000,14211000,29299000,23.80039349,86.41998572,24556,E,0.0008381173418888017
JHARKHAND,2007,855,534,303,342,15,801,0,2850,15316000,14429000,29745000,23.80039349,86.41998572,26868,E,0.0009032778618255168
JHARKHAND,2008,791,499,266,271,23,851,39,2740,15539000,14642000,30181000,23.80039349,86.41998572,25212,E,0.0008353599946986515
JHARKHAND,2009,719,517,295,276,83,710,6,2606,15759000,14852000,30611000,23.80039349,86.41998572,24199,E,0.0007905328150011433
JHARKHAND,2010,773,696,276,245,16,650,8,2664,15978000,15062000,31040000,23.80039349,86.41998572,25998,E,0.0008375644329896907
JHARKHAND,2011,784,660,282,317,7,659,6,2715,16198000,15274000,31472000,23.80039349,86.41998572,26233,E,0.0008335345704117947
JHARKHAND,2012,812,786,302,284,10,1261,3,3458,16418000,15486000,31904000,23.80039349,86.41998572,29833,E,0.0009350865095285858
JHARKHAND,2013,1204,926,307,524,18,2084,2,5065,16636000,15698000,32334000,23.80039349,86.41998572,40871,E,0.0012640254840106389
JHARKHAND,2014,1050,885,350,440,18,1462,2,4207,16855000,15910000,32765000,23.80039349,86.41998572,36510,E,0.0011142987944452922
KARNATAKA,2001,293,271,220,1665,81,1755,0,4285,26899000,25952000,52851000,12.57038129,76.91999711,24238,S,0.00045861005468203063
KARNATAKA,2002,292,300,233,1648,100,1826,0,4399,27243000,26312000,53555000,12.57038129,76.91999711,24893,S,0.0004648118756418635
KARNATAKA,2003,321,244,194,1585,84,1704,0,4132,27582000,26664000,54246000,12.57038129,76.91999711,23454,S,0.00043236367658444863
KARNATAKA,2004,291,286,259,1435,57,1588,0,3916,27916000,27010000,54926000,12.57038129,76.91999711,23220,S,0.0004227506099115173
KARNATAKA,2005,343,312,261,1585,71,1883,0,4455,28246000,27350000,55596000,12.57038129,76.91999711,25967,S,0.0004670659759694942
KARNATAKA,2006,400,328,244,1683,38,2129,0,4822,28573000,27685000,56258000,12.57038129,76.91999711,27856,S,0.0004951473568203633
KARNATAKA,2007,436,390,251,1828,28,2507,0,5440,28894000,28015000,56909000,12.57038129,76.91999711,30950,S,0.0005438507090266918
KARNATAKA,2008,446,405,259,1954,44,2638,1,5747,29212000,28338000,57550000,12.57038129,76.91999711,32451,S,0.0005638748913987837
KARNATAKA,2009,509,408,264,2186,64,3185,2,6618,29525000,28656000,58181000,12.57038129,76.91999711,36372,S,0.0006251525412076108
KARNATAKA,2010,586,586,248,2544,83,3441,0,7488,29835000,28969000,58804000,12.57038129,76.91999711,41662,S,0.0007084892184205156
KARNATAKA,2011,636,715,267,2608,81,3712,12,8031,30140000,29278000,59418000,12.57038129,76.91999711,45234,S,0.0007612844592547712
KARNATAKA,2012,621,1070,218,2978,100,3684,32,8703,30442000,29583000,60025000,12.57038129,76.91999711,49847,S,0.0008304373177842565
KARNATAKA,2013,1030,1359,277,3913,137,3276,0,9992,30740000,29883000,60623000,12.57038129,76.91999711,62999,S,0.0010391930455437705
KARNATAKA,2014,1324,1457,313,5263,170,3025,0,11552,31035000,30179000,61214000,12.57038129,76.91999711,75025,S,0.0012256183226059397
KERALA,2001,562,97,27,1942,81,2561,0,5270,15469000,16373000,31842000,8.900372741,76.56999263,27441,S,0.0008617863199547767
KERALA,2002,499,91,17,2123,102,2836,0,5668,15615000,16517000,32132000,8.900372741,76.56999263,28079,S,0.0008738640607494087
KERALA,2003,394,102,33,1947,68,2930,0,5474,15761000,16660000,32421000,8.900372741,76.56999263,26154,S,0.0008066993615249375
KERALA,2004,480,142,31,2260,133,3222,0,6268,15907000,16801000,32708000,8.900372741,76.56999263,30450,S,0.0009309649015531369
KERALA,2005,478,129,21,2339,175,3283,0,6425,16050000,16939000,32989000,8.900372741,76.56999263,30844,S,0.0009349783261087029
KERALA,2006,601,202,25,2543,222,3708,0,7301,16191000,17074000,33265000,8.900372741,76.56999263,35915,S,0.0010796633097850594
KERALA,2007,512,177,27,2624,262,3999,0,7601,16329000,17206000,33535000,8.900372741,76.56999263,35758,S,0.0010662889518413597
KERALA,2008,568,166,31,2745,258,4138,0,7906,16466000,17336000,33802000,8.900372741,76.56999263,37558,S,0.0011111176853440625
KERALA,2009,568,173,20,2540,395,4007,0,7703,16601000,17462000,34063000,8.900372741,76.56999263,36456,S,0.001070252179784517
KERALA,2010,634,184,22,2936,537,4797,0,9110,16732000,17585000,34317000,8.900372741,76.56999263,42362,S,0.0012344319142116153
KERALA,2011,1132,221,15,3756,573,5377,0,11074,16859000,17704000,34563000,8.900372741,76.56999263,56045,S,0.0016215316957440037
KERALA,2012,1019,214,32,3735,498,5216,0,10714,16983000,17819000,34802000,8.900372741,76.56999263,53722,S,0.0015436469168438596
KERALA,2013,1221,185,21,4362,404,4820,0,11013,17104000,17930000,35034000,8.900372741,76.56999263,57962,S,0.0016544499628931896
KERALA,2014,1347,143,28,4367,257,4919,0,11061,17221000,18037000,35258000,8.900372741,76.56999263,59418,S,0.0016852345566963525
MADHYA PRADESH,2001,2851,668,609,7063,751,2562,0,14504,31444000,28904000,60348000,21.30039105,76.13001949,103834,C,0.001720587260555445
MADHYA PRADESH,2002,2891,639,674,7118,783,3117,0,15222,32091000,29490000,61581000,21.30039105,76.13001949,107155,C,0.001740065929426284
MADHYA PRADESH,2003,2738,608,648,6848,705,2938,0,14485,32731000,30069000,62800000,21.30039105,76.13001949,102039,C,0.0016248248407643312
MADHYA PRADESH,2004,2875,584,751,6690,804,3436,0,15140,33364000,30641000,64005000,21.30039105,76.13001949,106400,C,0.001662370127333802
MADHYA PRADESH,2005,2921,604,739,6426,792,2989,3,14474,33993000,31209000,65202000,21.30039105,76.13001949,104443,C,0.001601837366951934
MADHYA PRADESH,2006,2900,617,764,6243,762,2989,0,14275,34617000,31773000,66390000,21.30039105,76.13001949,103598,C,0.0015604458502786564
MADHYA PRADESH,2007,3010,701,742,6772,780,3294,0,15299,35237000,32332000,67569000,21.30039105,76.13001949,109372,C,0.0016186712841687757
MADHYA PRADESH,2008,2937,736,805,6445,758,3185,0,14866,35851000,32886000,68737000,21.30039105,76.13001949,107544,C,0.0015645722100178943
MADHYA PRADESH,2009,2998,841,858,6307,728,3983,1,15716,36461000,33436000,69897000,21.30039105,76.13001949,111928,C,0.0016013276678541282
MADHYA PRADESH,2010,3135,1030,892,6646,918,3756,5,16382,37068000,33982000,71050000,21.30039105,76.13001949,118007,C,0.0016609007741027445
MADHYA PRADESH,2011,3406,1088,811,6665,762,3732,45,16509,37673000,34527000,72200000,21.30039105,76.13001949,121392,C,0.0016813296398891966
MADHYA PRADESH,2012,3425,1127,743,6655,774,3988,6,16718,38275000,35069000,73344000,21.30039105,76.13001949,121411,C,0.001655363765270506
MADHYA PRADESH,2013,4335,2873,776,8252,736,4988,7,21967,38874000,35608000,74482000,21.30039105,76.13001949,163897,C,0.0022004913938938266
MADHYA PRADESH,2014,5076,5688,733,9609,429,6451,0,27986,39471000,36144000,75615000,21.30039105,76.13001949,212700,C,0.0028129339416782385
MAHARASHTRA,2001,1302,611,308,2823,1120,6090,1,12255,50401000,46478000,96879000,19.25023195,73.16017493,66015,W,0.0006814170253615334
MAHARASHTRA,2002,1352,650,303,2686,769,5353,0,11113,51231000,47214000,98445000,19.25023195,73.16017493,63121,W,0.000641180354512672
MAHARASHTRA,2003,1268,626,368,2661,682,5452,0,11057,52074000,47956000,100030000,19.25023195,73.16017493,62507,W,0.0006248825352394282
MAHARASHTRA,2004,1388,787,314,2831,862,5646,0,11828,52923000,48701000,101624000,19.25023195,73.16017493,67079,W,0.0006600704557978431
MAHARASHTRA,2005,1545,851,341,3228,919,6233,0,13117,53775000,49444000,103219000,19.25023195,73.16017493,74396,W,0.0007207587750317286
MAHARASHTRA,2006,1500,921,387,3479,984,6738,1,14010,54623000,50181000,104804000,19.25023195,73.16017493,78086,W,0.0007450669821762528
MAHARASHTRA,2007,1451,967,436,3306,1039,7356,0,14555,55470000,50916000,106386000,19.25023195,73.16017493,79690,W,0.0007490647265617656
MAHARASHTRA,2008,1558,998,390,3619,1091,7829,0,15485,56321000,51651000,107972000,19.25023195,73.16017493,84055,W,0.0007784888674841626
MAHARASHTRA,2009,1483,926,341,3196,1099,7681,0,14726,57171000,52382000,109553000,19.25023195,73.16017493,78940,W,0.0007205644756419267
MAHARASHTRA,2010,1599,1124,393,3661,1180,7434,0,15391,58013000,53105000,111118000,19.25023195,73.16017493,85267,W,0.0007673554239637142
MAHARASHTRA,2011,1701,1252,339,3794,1071,7136,0,15293,58844000,53816000,112660000,19.25023195,73.16017493,86711,W,0.00076966980294692
MAHARASHTRA,2012,1839,1140,329,3935,1294,7415,0,15952,59666000,54519000,114185000,19.25023195,73.16017493,89722,W,0.0007857599509567807
MAHARASHTRA,2013,3063,1874,320,8132,2632,8542,0,24563,60482000,55215000,115697000,19.25023195,73.16017493,143667,W,0.0012417521629774324
MAHARASHTRA,2014,3438,2457,279,10001,1575,7696,1,25447,61289000,55900000,117189000,19.25023195,73.16017493,158153,W,0.0013495549923627644
MANIPUR,2001,20,62,0,21,0,5,0,108,1096000,1071000,2167000,24.79997072,93.95001705,1040,NE,0.000479926165205353
MANIPUR,2002,14,82,0,58,0,10,0,164,1109000,1086000,2195000,24.79997072,93.95001705,1350,NE,0.0006150341685649202
MANIPUR,2003,18,71,0,44,0,4,0,137,1123000,1100000,2223000,24.79997072,93.95001705,1212,NE,0.0005452091767881241
MANIPUR,2004,31,71,0,30,0,2,0,134,1137000,1114000,2251000,24.79997072,93.95001705,1331,NE,0.0005912927587738782
MANIPUR,2005,25,69,0,25,0,20,0,139,1151000,1129000,2280000,24.79997072,93.95001705,1250,NE,0.0005482456140350877
MANIPUR,2006,40,79,0,42,0,10,0,171,1165000,1143000,2308000,24.79997072,93.95001705,1630,NE,0.0007062391681109185
MANIPUR,2007,20,83,0,70,0,15,0,188,1179000,1157000,2336000,24.79997072,93.95001705,1525,NE,0.0006528253424657535
MANIPUR,2008,38,87,1,57,0,28,0,211,1193000,1171000,2364000,24.79997072,93.95001705,1824,NE,0.0007715736040609137
MANIPUR,2009,31,97,0,39,2,25,0,194,1207000,1186000,2393000,24.79997072,93.95001705,1711,NE,0.0007150020894274968
MANIPUR,2010,34,107,0,31,0,18,0,190,1221000,1200000,2421000,24.79997072,93.95001705,1789,NE,0.0007389508467575382
MANIPUR,2011,53,116,1,38,0,39,0,247,1235000,1214000,2449000,24.79997072,93.95001705,2277,NE,0.0009297672519395672
MANIPUR,2012,63,133,0,49,1,43,0,289,1249000,1229000,2478000,24.79997072,93.95001705,2652,NE,0.0010702179176755448
MANIPUR,2013,72,125,0,59,0,29,0,285,1263000,1243000,2506000,24.79997072,93.95001705,2712,NE,0.0010822027134876296
MANIPUR,2014,75,121,1,98,0,41,0,336,1277000,1258000,2535000,24.79997072,93.95001705,2963,NE,0.001168836291913215
MEGHALAYA,2001,26,11,0,25,0,4,0,66,1176000,1143000,2319000,25.57049217,91.8800142,637,NE,0.0002746873652436395
MEGHALAYA,2002,38,10,0,23,0,0,0,71,1191000,1158000,2349000,25.57049217,91.8800142,785,NE,0.0003341847594721158
MEGHALAYA,2003,40,10,0,13,1,4,0,68,1206000,1173000,2379000,25.57049217,91.8800142,780,NE,0.0003278688524590164
MEGHALAYA,2004,54,18,2,34,0,5,0,113,1221000,1189000,2410000,25.57049217,91.8800142,1205,NE,0.0005
MEGHALAYA,2005,63,19,1,44,0,3,0,130,1236000,1204000,2440000,25.57049217,91.8800142,1379,NE,0.0005651639344262295
MEGHALAYA,2006,74,25,6,57,0,13,0,175,1251000,1219000,2470000,25.57049217,91.8800142,1774,NE,0.0007182186234817814
MEGHALAYA,2007,82,22,2,45,1,19,0,171,1266000,1234000,2500000,25.57049217,91.8800142,1765,NE,0.000706
MEGHALAYA,2008,88,25,2,54,4,32,0,205,1280000,1250000,2530000,25.57049217,91.8800142,1978,NE,0.0007818181818181818
MEGHALAYA,2009,112,26,0,72,1,24,1,236,1295000,1265000,2560000,25.57049217,91.8800142,2385,NE,0.000931640625
MEGHALAYA,2010,149,37,0,48,0,24,0,258,1310000,1280000,2590000,25.57049217,91.8800142,2917,NE,0.0011262548262548262
MEGHALAYA,2011,130,37,1,74,1,21,3,267,1325000,1296000,2621000,25.57049217,91.8800142,2801,NE,0.0010686760778328883
MEGHALAYA,2012,164,24,1,43,0,16,0,248,1340000,1311000,2651000,25.57049217,91.8800142,2978,NE,0.0011233496793662768
MEGHALAYA,2013,183,33,2,98,0,23,0,339,1355000,1326000,2681000,25.57049217,91.8800142,3664,NE,0.0013666542334949646
MEGHALAYA,2014,118,38,1,105,54,42,0,358,1370000,1342000,2712000,25.57049217,91.8800142,2978,NE,0.0010980825958702065
MIZORAM,2001,52,1,0,52,0,16,3,124,459000,429000,888000,23.71039899,92.72001461,1128,NE,0.0012702702702702703
MIZORAM,2002,76,2,0,73,0,3,0,154,465000,435000,900000,23.71039899,92.72001461,1534,NE,0.0017044444444444444
MIZORAM,2003,54,2,0,88,0,3,0,147,471000,441000,912000,23.71039899,92.72001461,1279,NE,0.0014024122807017544
MIZORAM,2004,20,0,0,66,0,0,0,86,477000,447000,924000,23.71039899,92.72001461,630,NE,0.0006818181818181819
MIZORAM,2005,37,0,4,49,4,0,0,94,482000,452000,934000,23.71039899,92.72001461,872,NE,0.0009336188436830836
MIZORAM,2006,72,1,0,51,0,1,0,125,488000,458000,946000,23.71039899,92.72001461,1348,NE,0.0014249471458773785
MIZORAM,2007,83,0,0,66,0,2,0,151,494000,464000,958000,23.71039899,92.72001461,1581,NE,0.001650313152400835
MIZORAM,2008,77,1,0,78,0,5,0,161,500000,470000,970000,23.71039899,92.72001461,1570,NE,0.001618556701030928
MIZORAM,2009,83,0,0,61,1,4,0,149,506000,475000,981000,23.71039899,92.72001461,1565,NE,0.0015953109072375127
MIZORAM,2010,92,0,0,75,0,3,0,170,512000,481000,993000,23.71039899,92.72001461,1764,NE,0.0017764350453172205
MIZORAM,2011,77,0,0,72,1,9,0,159,517000,487000,1004000,23.71039899,92.72001461,1545,NE,0.0015388446215139442
MIZORAM,2012,103,3,0,85,0,8,0,199,523000,493000,1016000,23.71039899,92.72001461,2024,NE,0.0019921259842519685
MIZORAM,2013,89,2,0,81,0,5,0,177,529000,498000,1027000,23.71039899,92.72001461,1775,NE,0.0017283349561830574
MIZORAM,2014,120,3,0,97,29,8,0,257,535000,504000,1039000,23.71039899,92.72001461,2426,NE,0.0023349374398460056
NAGALAND,2001,17,6,0,6,0,0,0,29,1047000,943000,1990000,25.6669979,94.11657019,345,NE,0.00017336683417085427
NAGALAND,2002,17,4,0,1,0,0,0,22,1060000,956000,2016000,25.6669979,94.11657019,300,NE,0.00014880952380952382
NAGALAND,2003,14,3,0,4,2,0,1,24,1074000,968000,2042000,25.6669979,94.11657019,276,NE,0.00013516160626836436
NAGALAND,2004,18,4,0,3,1,0,0,26,1087000,981000,2068000,25.6669979,94.11657019,328,NE,0.0001586073500967118
NAGALAND,2005,17,9,0,7,0,0,0,33,1100000,993000,2093000,25.6669979,94.11657019,380,NE,0.00018155757286192068
NAGALAND,2006,23,3,0,3,2,3,0,34,1113000,1006000,2119000,25.6669979,94.11657019,405,NE,0.0001911278905143936
NAGALAND,2007,13,6,0,8,1,0,0,28,1127000,1019000,2146000,25.6669979,94.11657019,298,NE,0.00013886300093196645
NAGALAND,2008,19,7,0,15,1,4,0,46,1140000,1031000,2171000,25.6669979,94.11657019,445,NE,0.00020497466605251037
NAGALAND,2009,22,10,0,11,0,0,0,43,1153000,1044000,2197000,25.6669979,94.11657019,485,NE,0.00022075557578516157
NAGALAND,2010,16,6,0,13,3,1,0,39,1167000,1056000,2223000,25.6669979,94.11657019,377,NE,0.0001695906432748538
NAGALAND,2011,23,3,0,9,0,1,0,36,1180000,1069000,2249000,25.6669979,94.11657019,423,NE,0.00018808359270787016
NAGALAND,2012,21,10,0,16,0,0,0,47,1193000,1082000,2275000,25.6669979,94.11657019,495,NE,0.00021758241758241758
NAGALAND,2013,31,11,1,18,1,4,0,66,1207000,1094000,2301000,25.6669979,94.11657019,695,NE,0.0003020425901781834
NAGALAND,2014,30,13,0,16,1,3,0,63,1220000,1107000,2327000,25.6669979,94.11657019,672,NE,0.00028878384185646754
ODISHA,2001,790,434,294,1655,458,1266,0,4897,18661000,18144000,36805000,19.82042971,85.90001746,34047,E,0.0009250645292759136
ODISHA,2002,691,432,248,1605,188,1167,0,4331,18879000,18365000,37244000,19.82042971,85.90001746,30495,E,0.0008187896036945548
ODISHA,2003,725,373,279,1669,188,1289,0,4523,19091000,18580000,37671000,19.82042971,85.90001746,31566,E,0.0008379389981683523
ODISHA,2004,770,423,319,1811,170,1192,0,4685,19296000,18789000,38085000,19.82042971,85.90001746,33706,E,0.0008850203492188525
ODISHA,2005,799,547,334,2238,184,1671,0,5773,19496000,18994000,38490000,19.82042971,85.90001746,39220,E,0.0010189659651857626
ODISHA,2006,985,577,457,2415,247,694,12,5387,19692000,19196000,38888000,19.82042971,85.90001746,42418,E,0.0010907735033943633
ODISHA,2007,939,660,461,2775,241,728,0,5804,19883000,19393000,39276000,19.82042971,85.90001746,44382,E,0.001130003055300947
ODISHA,2008,1113,762,401,2782,282,1618,0,6958,20068000,19586000,39654000,19.82042971,85.90001746,49940,E,0.0012593937559893075
ODISHA,2009,1023,799,384,2697,210,2047,1,7161,20249000,19776000,40025000,19.82042971,85.90001746,49361,E,0.001233254216114928
ODISHA,2010,1025,912,388,2905,232,2067,5,7534,20427000,19963000,40390000,19.82042971,85.90001746,51787,E,0.0012821738053973757
ODISHA,2011,1112,1008,465,3207,235,2320,0,8347,20602000,20148000,40750000,19.82042971,85.90001746,57435,E,0.0014094478527607362
ODISHA,2012,1458,1364,525,4187,304,2638,0,10476,20774000,20330000,41104000,19.82042971,85.90001746,73146,E,0.0017795348384585443
ODISHA,2013,1832,2067,395,4618,426,2792,0,12130,20943000,20510000,41453000,19.82042971,85.90001746,86819,E,0.002094396063011121
ODISHA,2014,1978,2436,441,5543,379,3114,0,13891,21109000,20688000,41797000,19.82042971,85.90001746,98839,E,0.002364739096107376
PUNJAB,2001,298,324,159,372,47,1128,0,2328,12985000,11374000,24359000,31.51997398,75.98000281,15480,N,0.0006354940679009812
PUNJAB,2002,299,354,166,341,145,944,0,2249,13179000,11520000,24699000,31.51997398,75.98000281,15487,N,0.0006270294343900562
PUNJAB,2003,380,295,110,346,199,987,0,2317,13374000,11667000,25041000,31.51997398,75.98000281,15588,N,0.0006224991014735833
PUNJAB,2004,390,311,113,261,38,801,0,1914,13570000,11814000,25384000,31.51997398,75.98000281,14477,N,0.0005703198865427041
PUNJAB,2005,398,329,99,308,43,729,0,1906,13764000,11960000,25724000,31.51997398,75.98000281,14601,N,0.0005676022391540973
PUNJAB,2006,442,418,130,314,60,801,2,2167,13956000,12104000,26060000,31.51997398,75.98000281,16933,N,0.0006497697620874904
PUNJAB,2007,519,545,133,427,48,971,0,2643,14146000,12245000,26391000,31.51997398,75.98000281,20422,N,0.0007738244098366867
PUNJAB,2008,517,514,128,388,49,984,0,2580,14335000,12386000,26721000,31.51997398,75.98000281,19854,N,0.000743011114853486
PUNJAB,2009,511,513,126,319,33,1061,0,2563,14523000,12525000,27048000,31.51997398,75.98000281,19562,N,0.0007232327713694173
PUNJAB,2010,546,576,121,349,38,1163,0,2793,14707000,12661000,27368000,31.51997398,75.98000281,21113,N,0.0007714484068985677
PUNJAB,2011,479,517,143,282,31,1136,0,2588,14886000,12792000,27678000,31.51997398,75.98000281,19411,N,0.0007013151239251391
PUNJAB,2012,680,689,118,340,31,1293,0,3151,15061000,12920000,27981000,31.51997398,75.98000281,24532,N,0.0008767377863550266
PUNJAB,2013,888,987,126,1045,67,1741,0,4854,15233000,13046000,28279000,31.51997398,75.98000281,35729,N,0.0012634463736341454
PUNJAB,2014,981,1176,90,1113,35,1681,0,5076,15401000,13167000,28568000,31.51997398,75.98000281,38538,N,0.001348991879025483
RAJASTHAN,2001,1049,2165,376,2878,56,5532,1,12057,29420000,27087000,56507000,27.0238,74.2179,74189,W,0.0013129169837365281
RAJASTHAN,2002,1051,2019,399,2730,44,5691,0,11934,30031000,27633000,57664000,27.0238,74.2179,72795,W,0.0012623994173140954
RAJASTHAN,2003,1050,1750,389,2715,33,5733,1,11671,30644000,28181000,58825000,27.0238,74.2179,69968,W,0.0011894262643433915
RAJASTHAN,2004,1038,1881,379,2825,41,6781,1,12946,31256000,28728000,59984000,27.0238,74.2179,74666,W,0.0012447652707388637
RAJASTHAN,2005,993,1549,361,2503,28,5997,0,11431,31864000,29272000,61136000,27.0238,74.2179,66390,W,0.0010859395446218268
RAJASTHAN,2006,1085,1553,394,2582,31,7038,3,12686,32466000,29811000,62277000,27.0238,74.2179,71862,W,0.0011539091478394914
RAJASTHAN,2007,1238,1694,439,2477,28,8170,0,14046,33062000,30345000,63407000,27.0238,74.2179,79074,W,0.0012470862838487864
RAJASTHAN,2008,1355,1863,439,2520,19,8113,0,14309,33656000,30877000,64533000,27.0238,74.2179,82536,W,0.001278973548417089
RAJASTHAN,2009,1519,2310,436,2485,24,10371,0,17145,34245000,31405000,65650000,27.0238,74.2179,96035,W,0.0014628332063975629
RAJASTHAN,2010,1571,2477,462,2339,23,11145,0,18017,34825000,31925000,66750000,27.0238,74.2179,100464,W,0.0015050786516853933
RAJASTHAN,2011,1800,2713,514,2447,9,12218,0,19701,35394000,32436000,67830000,27.0238,74.2179,110756,W,0.0016328468229397021
RAJASTHAN,2012,2049,2697,478,2352,18,13312,0,20906,35954000,32938000,68892000,27.0238,74.2179,116625,W,0.0016928670963246822
RAJASTHAN,2013,3285,4047,453,4829,25,15094,1,27734,36506000,33434000,69940000,27.0238,74.2179,166052,W,0.002374206462682299
RAJASTHAN,2014,3759,4421,408,5999,18,15905,0,30510,37048000,33921000,70969000,27.0238,74.2179,184479,W,0.002599430737364201
SIKKIM,2001,8,2,0,0,14,0,0,24,288000,252000,540000,27.3333303,88.6166475,182,NE,0.00033703703703703706
SIKKIM,2002,6,2,0,17,0,3,0,28,292000,255000,547000,27.3333303,88.6166475,204,NE,0.0003729433272394881
SIKKIM,2003,10,0,0,25,0,1,0,36,296000,259000,555000,27.3333303,88.6166475,278,NE,0.000500900900900901
SIKKIM,2004,3,4,0,40,0,1,0,48,299000,262000,561000,27.3333303,88.6166475,288,NE,0.0005133689839572192
SIKKIM,2005,18,2,0,38,0,4,0,62,303000,266000,569000,27.3333303,88.6166475,492,NE,0.0008646748681898067
SIKKIM,2006,20,7,0,14,0,6,0,47,307000,269000,576000,27.3333303,88.6166475,458,NE,0.0007951388888888888
SIKKIM,2007,24,9,0,13,0,7,0,53,310000,273000,583000,27.3333303,88.6166475,536,NE,0.0009193825042881647
SIKKIM,2008,20,4,0,19,0,5,0,48,314000,276000,590000,27.3333303,88.6166475,450,NE,0.0007627118644067797
SIKKIM,2009,18,6,0,10,0,6,0,40,318000,280000,598000,27.3333303,88.6166475,398,NE,0.0006655518394648829
SIKKIM,2010,18,6,1,11,0,3,0,39,321000,284000,605000,27.3333303,88.6166475,409,NE,0.0006760330578512397
SIKKIM,2011,16,10,0,24,0,4,0,54,325000,287000,612000,27.3333303,88.6166475,472,NE,0.0007712418300653595
SIKKIM,2012,34,10,1,19,0,4,0,68,329000,291000,620000,27.3333303,88.6166475,732,NE,0.0011806451612903226
SIKKIM,2013,43,16,0,29,0,5,0,93,332000,294000,626000,27.3333303,88.6166475,965,NE,0.0015415335463258785
SIKKIM,2014,47,12,0,34,3,5,0,101,336000,297000,633000,27.3333303,88.6166475,1019,NE,0.0016097946287519746
TAMIL NADU,2001,423,607,191,1773,1012,815,14,4835,31401000,31005000,62406000,11.1271,78.6569,29766,S,0.00047697336794538987
TAMIL NADU,2002,534,714,243,1877,1718,1052,0,6138,31685000,31304000,62989000,11.1271,78.6569,36490,S,0.0005793074981345949
TAMIL NADU,2003,557,632,220,2022,881,1555,1,5868,31959000,31593000,63552000,11.1271,78.6569,35403,S,0.0005570713746223565
TAMIL NADU,2004,618,692,225,1861,1081,1437,0,5914,32224000,31872000,64096000,11.1271,78.6569,36424,S,0.00056827259111333
TAMIL NADU,2005,571,783,215,1764,665,1650,0,5648,32481000,32142000,64623000,11.1271,78.6569,35385,S,0.0005475604660879253
TAMIL NADU,2006,457,718,187,1179,852,1248,0,4641,32730000,32405000,65135000,11.1271,78.6569,29035,S,0.00044576648499270745
TAMIL NADU,2007,523,1097,208,1540,875,1976,0,6219,32971000,32658000,65629000,11.1271,78.6569,38188,S,0.0005818769141690411
TAMIL NADU,2008,573,1160,207,1705,974,1648,0,6267,33203000,32903000,66106000,11.1271,78.6569,39691,S,0.0006004144858257949
TAMIL NADU,2009,596,1133,194,1242,501,1460,0,5126,33426000,33140000,66566000,11.1271,78.6569,35273,S,0.0005298951416639125
TAMIL NADU,2010,686,1464,165,1405,638,1570,0,5928,33643000,33369000,67012000,11.1271,78.6569,41054,S,0.0006126365427087686
TAMIL NADU,2011,677,1743,152,1467,464,1812,0,6315,33852000,33592000,67444000,11.1271,78.6569,44028,S,0.0006528082557380938
TAMIL NADU,2012,737,1693,110,1494,382,1965,0,6381,34054000,33808000,67862000,11.1271,78.6569,44146,S,0.0006505260676077923
TAMIL NADU,2013,923,1516,118,1271,313,2471,0,6612,34248000,34017000,68265000,11.1271,78.6569,45482,S,0.0006662565004028418
TAMIL NADU,2014,455,1502,95,1102,229,2103,0,5486,34435000,34218000,68653000,11.1271,78.6569,35776,S,0.000521113425487597
TRIPURA,2001,102,35,16,58,0,227,0,438,1642000,1557000,3199000,23.83540428,91.27999914,3091,NE,0.0009662394498280713
TRIPURA,2002,108,48,16,128,0,236,0,536,1663000,1587000,3250000,23.83540428,91.27999914,3688,NE,0.0011347692307692309
TRIPURA,2003,114,29,20,127,0,247,0,537,1684000,1599000,3283000,23.83540428,91.27999914,3676,NE,0.0011197075845263478
TRIPURA,2004,160,54,20,134,0,302,0,670,1705000,1620000,3325000,23.83540428,91.27999914,4816,NE,0.0014484210526315789
TRIPURA,2005,162,43,34,161,1,439,0,840,1725000,1640000,3365000,23.83540428,91.27999914,5495,NE,0.0016329866270430907
TRIPURA,2006,189,62,35,207,0,471,0,964,1746000,1661000,3407000,23.83540428,91.27999914,6428,NE,0.0018867038450249487
TRIPURA,2007,157,81,36,244,4,545,0,1067,1767000,1682000,3449000,23.83540428,91.27999914,6572,NE,0.0019054798492316614
TRIPURA,2008,204,110,16,346,4,735,0,1415,1788000,1703000,3491000,23.83540428,91.27999914,8347,NE,0.0023910054425666
TRIPURA,2009,190,92,29,384,5,815,0,1515,1809000,1724000,3533000,23.83540428,91.27999914,8585,NE,0.002429946221341636
TRIPURA,2010,238,91,25,376,9,937,0,1676,1830000,1744000,3574000,23.83540428,91.27999914,9573,NE,0.002678511471740347
TRIPURA,2011,205,116,30,294,9,702,0,1356,1851000,1765000,3616000,23.83540428,91.27999914,8288,NE,0.0022920353982300887
TRIPURA,2012,229,114,37,314,7,858,0,1559,1872000,1786000,3658000,23.83540428,91.27999914,9295,NE,0.002541006014215418
TRIPURA,2013,233,124,29,407,7,827,0,1627,1893000,1807000,3700000,23.83540428,91.27999914,9707,NE,0.0026235135135135135
TRIPURA,2014,239,102,33,492,11,702,0,1579,1914000,1828000,3742000,23.83540428,91.27999914,9699,NE,0.00259192944949225
UTTAR PRADESH,2001,1958,2879,2211,2870,2575,7365,0,19858,87565000,78633000,166198000,27.59998069,78.05000565,135495,C,0.0008152625182011817
UTTAR PRADESH,2002,1415,2298,1893,2145,1887,5679,0,15317,89337000,80211000,169548000,27.59998069,78.05000565,106023,C,0.0006253273409300022
UTTAR PRADESH,2003,911,1499,1322,1098,4970,2626,0,12426,91132000,81812000,172944000,27.59998069,78.05000565,76763,C,0.0004438604403737626
UTTAR PRADESH,2004,1397,2324,1708,1900,2682,4950,3,14964,92943000,83431000,176374000,27.59998069,78.05000565,102241,C,0.0005796829464660324
UTTAR PRADESH,2005,1217,2256,1564,1835,2881,4505,0,14258,94765000,85060000,179825000,27.59998069,78.05000565,95608,C,0.000531672459335465
UTTAR PRADESH,2006,1314,2551,1798,2096,2714,5204,0,15677,96589000,86693000,183282000,27.59998069,78.05000565,106424,C,0.0005806571294507917
UTTAR PRADESH,2007,1648,3363,2076,2522,2882,7650,0,20141,98421000,88335000,186756000,27.59998069,78.05000565,133696,C,0.0007158859688577609
UTTAR PRADESH,2008,1871,4439,2237,2955,3374,8312,0,23188,100264000,89989000,190253000,27.59998069,78.05000565,155843,C,0.0008191355721066159
UTTAR PRADESH,2009,1759,5078,2232,2782,2524,8566,0,22941,102113000,91650000,193763000,27.59998069,78.05000565,157825,C,0.0008145259930946568
UTTAR PRADESH,2010,1563,5468,2217,2793,11,7978,0,20030,103960000,93311000,197271000,27.59998069,78.05000565,149312,C,0.0007568877331184005
UTTAR PRADESH,2011,2042,7525,2322,3455,3,7121,0,22468,105798000,94966000,200764000,27.59998069,78.05000565,179357,C,0.0008933723177462095
UTTAR PRADESH,2012,1963,7910,2244,3247,8,7661,0,23033,107632000,96618000,204250000,27.59998069,78.05000565,181447,C,0.0008883574051407588
UTTAR PRADESH,2013,3050,9737,2335,7303,25,8781,0,31231,107632000,98273000,205905000,27.59998069,78.05000565,241078,C,0.0011708214953497973
UTTAR PRADESH,2014,3467,10626,2469,8605,29,10471,0,35667,111294000,99923000,211217000,27.59998069,78.05000565,269825,C,0.001277477665150059
UTTARAKHAND,2001,74,126,56,103,84,301,0,744,4326000,4163000,8489000,30.32040895,78.05000565,4880,N,0.0005748615855813405
UTTARAKHAND,2002,89,155,66,145,97,316,1,869,4400000,4234000,8634000,30.32040895,78.05000565,5849,N,0.000677438035672921
UTTARAKHAND,2003,107,134,93,136,98,317,0,885,4474000,4306000,8780000,30.32040895,78.05000565,6265,N,0.0007135535307517084
UTTARAKHAND,2004,115,127,82,143,110,405,0,982,4549000,4377000,8926000,30.32040895,78.05000565,6485,N,0.0007265292404212414
UTTARAKHAND,2005,133,125,63,100,89,272,0,782,4624000,4449000,9073000,30.32040895,78.05000565,5773,N,0.0006362834784525515
UTTARAKHAND,2006,147,183,80,153,113,358,0,1034,4699000,4520000,9219000,30.32040895,78.05000565,7413,N,0.0008041002277904328
UTTARAKHAND,2007,117,227,70,146,63,463,0,1086,4774000,4591000,9365000,30.32040895,78.05000565,7383,N,0.000788360918312867
UTTARAKHAND,2008,87,222,73,120,306,340,0,1148,4849000,4662000,9511000,30.32040895,78.05000565,7158,N,0.0007526022500262854
UTTARAKHAND,2009,111,247,94,119,249,361,0,1181,4924000,4732000,9656000,30.32040895,78.05000565,7970,N,0.0008253935376967688
UTTARAKHAND,2010,121,249,75,125,165,334,0,1069,4998000,4802000,9800000,30.32040895,78.05000565,7552,N,0.0007706122448979592
UTTARAKHAND,2011,129,283,83,116,72,307,0,990,5072000,4871000,9943000,30.32040895,78.05000565,7727,N,0.0007771296389419692
UTTARAKHAND,2012,148,256,71,139,73,368,0,1055,5145000,4939000,10084000,30.32040895,78.05000565,7863,N,0.0007797500991669973
UTTARAKHAND,2013,228,633,43,295,72,435,0,1706,5217000,5006000,10223000,30.32040895,78.05000565,13391,N,0.0013098894649320161
UTTARAKHAND,2014,270,275,38,343,4,301,0,1231,5290000,5073000,10363000,30.32040895,78.05000565,10000,N,0.0009649715333397665
WEST BENGAL,2001,709,695,265,954,48,3859,3,6533,41466000,38710000,80176000,22.58039044,88.32994665,38081,E,0.0004749675713430453
WEST BENGAL,2002,759,694,273,964,34,4069,1,6794,42009000,39269000,81278000,22.58039044,88.32994665,39559,E,0.0004867122714633726
WEST BENGAL,2003,1002,801,329,1186,71,4948,1,8338,42523000,39798000,82321000,22.58039044,88.32994665,48972,E,0.0005948907326198662
WEST BENGAL,2004,1475,1018,396,1566,64,6334,12,10865,43013000,40303000,83316000,22.58039044,88.32994665,65389,E,0.000784831244898939
WEST BENGAL,2005,1686,1039,446,1572,54,6936,61,11794,43486000,40791000,84277000,22.58039044,88.32994665,71810,E,0.0008520711463388588
WEST BENGAL,2006,1731,1199,445,1837,63,7414,1,12690,43947000,41268000,85215000,22.58039044,88.32994665,76256,E,0.0008948659273602065
WEST BENGAL,2007,2106,1590,451,2281,99,9900,5,16432,44394000,41731000,86125000,22.58039044,88.32994665,95707,E,0.0011112568940493468
WEST BENGAL,2008,2263,1907,451,2396,94,13663,5,20779,44820000,42174000,86994000,22.58039044,88.32994665,113081,E,0.0012998712554888844
WEST BENGAL,2009,2336,2187,506,1942,108,16112,5,23196,45234000,42605000,87839000,22.58039044,88.32994665,122920,E,0.0013993784082241374
WEST BENGAL,2010,2311,2764,507,2465,163,17796,8,26014,45640000,43029000,88669000,22.58039044,88.32994665,136192,E,0.0015359595800110524
WEST BENGAL,2011,2363,3711,510,2363,200,19772,0,28919,46045000,43454000,89499000,22.58039044,88.32994665,151936,E,0.0016976279064570554
WEST BENGAL,2012,2046,4168,593,3345,556,19865,12,30585,46445000,43874000,90319000,22.58039044,88.32994665,159373,E,0.0017645567377849623
WEST BENGAL,2013,1685,3830,481,4913,577,18116,9,29611,46836000,44287000,91123000,22.58039044,88.32994665,151524,E,0.0016628513108655333
WEST BENGAL,2014,1466,4976,501,5670,543,23278,4,36438,47223000,44697000,91920000,22.58039044,88.32994665,179118,E,0.0019486292428198433
A & N ISLANDS,2001,3,2,0,19,1,9,0,34,193000,163000,356000,11.66702557,92.73598262,190,E,0.0005337078651685394
A & N ISLANDS,2002,2,1,0,17,3,4,0,27,201000,165000,366000,11.66702557,92.73598262,146,E,0.00039890710382513663
A & N ISLANDS,2003,2,2,0,9,2,7,0,22,209000,169000,378000,11.66702557,92.73598262,122,E,0.00032275132275132277
A & N ISLANDS,2004,10,3,0,6,3,5,0,27,217000,174000,391000,11.66702557,92.73598262,234,E,0.00059846547314578
A & N ISLANDS,2005,4,1,0,11,1,5,0,22,224000,181000,405000,11.66702557,92.73598262,143,E,0.0003530864197530864
A & N ISLANDS,2006,6,5,0,14,4,7,0,36,231000,188000,419000,11.66702557,92.73598262,243,E,0.0005799522673031026
A & N ISLANDS,2007,3,9,1,21,2,18,0,54,238000,196000,434000,11.66702557,92.73598262,315,E,0.0007258064516129033
A & N ISLANDS,2008,12,13,2,24,3,26,0,80,244000,205000,449000,11.66702557,92.73598262,547,E,0.0012182628062360802
A & N ISLANDS,2009,18,14,1,30,7,21,0,91,250000,215000,465000,11.66702557,92.73598262,659,E,0.001417204301075269
A & N ISLANDS,2010,24,8,0,31,10,9,0,82,256000,224000,480000,11.66702557,92.73598262,652,E,0.0013583333333333334
A & N ISLANDS,2011,13,12,0,15,3,5,0,48,261000,233000,494000,11.66702557,92.73598262,414,E,0.0008380566801619434
A & N ISLANDS,2012,12,7,2,17,4,5,0,47,266000,241000,507000,11.66702557,92.73598262,392,E,0.0007731755424063117
A & N ISLANDS,2013,27,12,1,45,8,9,0,102,271000,250000,521000,11.66702557,92.73598262,816,E,0.0015662188099808062
A & N ISLANDS,2014,32,17,3,41,5,14,0,112,275000,257000,532000,11.66702557,92.73598262,957,E,0.0017988721804511278
CHANDIGARH,2001,18,50,3,24,15,36,0,146,507000,394000,901000,30.71999697,76.78000565,1088,N,0.0012075471698113208
CHANDIGARH,2002,18,47,1,36,28,56,0,186,523000,400000,923000,30.71999697,76.78000565,1187,N,0.00128602383531961
CHANDIGARH,2003,18,28,1,11,4,93,0,155,544000,412000,956000,30.71999697,76.78000565,911,N,0.000952928870292887
CHANDIGARH,2004,19,43,6,20,18,73,0,179,571000,430000,1001000,30.71999697,76.78000565,1178,N,0.0011768231768231768
CHANDIGARH,2005,33,45,3,31,9,75,0,196,600000,450000,1050000,30.71999697,76.78000565,1397,N,0.0013304761904761905
CHANDIGARH,2006,19,57,10,20,13,102,0,221,632000,471000,1103000,30.71999697,76.78000565,1450,N,0.001314596554850408
CHANDIGARH,2007,22,46,1,32,11,112,0,224,667000,495000,1162000,30.71999697,76.78000565,1334,N,0.0011480206540447505
CHANDIGARH,2008,20,42,3,19,2,49,0,135,705000,522000,1227000,30.71999697,76.78000565,1013,N,0.0008255908720456398
CHANDIGARH,2009,29,36,2,26,2,51,0,146,747000,550000,1297000,30.71999697,76.78000565,1114,N,0.000858905165767155
CHANDIGARH,2010,31,28,5,29,4,41,0,138,789000,579000,1368000,30.71999697,76.78000565,1100,N,0.000804093567251462
CHANDIGARH,2011,27,46,2,21,12,46,0,154,832000,606000,1438000,30.71999697,76.78000565,1174,N,0.0008164116828929068
CHANDIGARH,2012,27,66,5,45,25,73,0,241,876000,632000,1508000,30.71999697,76.78000565,1659,N,0.0011001326259946949
CHANDIGARH,2013,45,174,1,143,26,92,0,481,921000,659000,1580000,30.71999697,76.78000565,3499,N,0.0022145569620253165
CHANDIGARH,2014,59,133,2,87,2,141,0,424,967000,684000,1651000,30.71999697,76.78000565,3109,N,0.0018831011508176863
D & N HAVELI,2001,6,2,0,7,0,4,0,19,122000,99000,221000,20.26657819,73.0166178,157,W,0.0007104072398190045
D & N HAVELI,2002,4,5,0,3,0,3,0,15,128000,94000,222000,20.26657819,73.0166178,134,W,0.0006036036036036036
D & N HAVELI,2003,1,4,0,4,0,2,0,11,135000,94000,229000,20.26657819,73.0166178,81,W,0.0003537117903930131
D & N HAVELI,2004,7,7,0,5,0,3,0,22,142000,97000,239000,20.26657819,73.0166178,209,W,0.0008744769874476987
D & N HAVELI,2005,5,9,0,5,0,5,0,24,150000,103000,253000,20.26657819,73.0166178,205,W,0.0008102766798418973
D & N HAVELI,2006,6,14,1,5,1,5,0,32,157000,109000,266000,20.26657819,73.0166178,288,W,0.0010827067669172932
D & N HAVELI,2007,7,6,0,0,0,3,0,16,164000,117000,281000,20.26657819,73.0166178,174,W,0.0006192170818505338
D & N HAVELI,2008,6,11,0,4,0,4,0,25,172000,127000,299000,20.26657819,73.0166178,232,W,0.0007759197324414715
D & N HAVELI,2009,4,9,0,2,1,3,0,19,179000,139000,318000,20.26657819,73.0166178,172,W,0.0005408805031446541
D & N HAVELI,2010,3,10,0,11,2,3,0,29,187000,150000,337000,20.26657819,73.0166178,215,W,0.0006379821958456973
D & N HAVELI,2011,4,8,0,2,0,3,0,17,194000,160000,354000,20.26657819,73.0166178,159,W,0.00044915254237288133
D & N HAVELI,2012,3,9,0,2,0,0,0,14,201000,169000,370000,20.26657819,73.0166178,145,W,0.0003918918918918919
D & N HAVELI,2013,5,11,0,1,1,1,0,19,208000,178000,386000,20.26657819,73.0166178,196,W,0.0005077720207253886
D & N HAVELI,2014,5,7,0,2,1,6,0,21,215000,187000,402000,20.26657819,73.0166178,176,W,0.00043781094527363184
DAMAN & DIU,2001,0,3,0,0,0,4,0,7,93000,66000,159000,20.227,73.0169,42,W,0.0002641509433962264
DAMAN & DIU,2002,0,2,0,0,0,3,0,5,100000,71000,171000,20.227,73.0169,29,W,0.0001695906432748538
DAMAN & DIU,2003,5,1,1,3,0,0,0,10,107000,75000,182000,20.227,73.0169,115,W,0.0006318681318681319
DAMAN & DIU,2004,1,0,0,1,0,4,0,6,115000,79000,194000,20.227,73.0169,32,W,0.00016494845360824742
DAMAN & DIU,2005,2,2,1,1,0,3,0,9,123000,82000,205000,20.227,73.0169,79,W,0.0003853658536585366
DAMAN & DIU,2006,3,1,0,2,0,2,0,8,131000,85000,216000,20.227,73.0169,71,W,0.0003287037037037037
DAMAN & DIU,2007,1,1,1,0,0,3,0,6,139000,88000,227000,20.227,73.0169,49,W,0.0002158590308370044
DAMAN & DIU,2008,0,1,0,2,1,5,0,9,148000,89000,237000,20.227,73.0169,38,W,0.00016033755274261603
DAMAN & DIU,2009,1,0,0,4,1,3,0,9,157000,91000,248000,20.227,73.0169,47,W,0.00018951612903225806
DAMAN & DIU,2010,1,2,0,2,0,3,0,8,166000,93000,259000,20.227,73.0169,54,W,0.00020849420849420848
DAMAN & DIU,2011,1,2,0,0,0,2,0,5,175000,95000,270000,20.227,73.0169,41,W,0.00015185185185185185
DAMAN & DIU,2012,5,0,0,0,0,3,0,8,184000,97000,281000,20.227,73.0169,84,W,0.000298932384341637
DAMAN & DIU,2013,8,6,0,2,0,2,0,18,193000,99000,292000,20.227,73.0169,196,W,0.0006712328767123287
DAMAN & DIU,2014,2,1,0,3,0,1,0,7,203000,102000,305000,20.227,73.0169,58,W,0.0001901639344262295
LAKSHADWEEP,2001,0,0,0,0,0,0,0,0,31000,30000,61000,10.5593,72.6358,0,S,0.0
LAKSHADWEEP,2002,1,0,0,1,0,0,0,2,32000,32000,64000,10.5593,72.6358,20,S,0.0003125
LAKSHADWEEP,2003,2,0,0,1,0,1,0,4,34000,33000,67000,10.5593,72.6358,38,S,0.0005671641791044777
LAKSHADWEEP,2004,0,0,0,0,0,1,0,1,34000,34000,68000,10.5593,72.6358,3,S,4.411764705882353e-05
LAKSHADWEEP,2005,0,0,0,0,0,0,0,0,35000,35000,70000,10.5593,72.6358,0,S,0.0
LAKSHADWEEP,2006,0,0,0,0,0,1,0,1,36000,36000,72000,10.5593,72.6358,3,S,4.1666666666666665e-05
LAKSHADWEEP,2007,1,0,0,2,0,2,0,5,37000,37000,74000,10.5593,72.6358,31,S,0.00041891891891891893
LAKSHADWEEP,2008,2,1,0,0,0,1,0,4,37000,37000,74000,10.5593,72.6358,43,S,0.0005810810810810811
LAKSHADWEEP,2009,1,0,0,0,0,0,0,1,37000,37000,74000,10.5593,72.6358,15,S,0.0002027027027027027
LAKSHADWEEP,2010,0,0,0,0,0,0,0,0,38000,38000,76000,10.5593,72.6358,0,S,0.0
LAKSHADWEEP,2011,0,0,0,0,0,0,0,0,38000,38000,76000,10.5593,72.6358,0,S,0.0
LAKSHADWEEP,2012,0,0,0,1,0,1,0,2,38000,39000,77000,10.5593,72.6358,8,S,0.0001038961038961039
LAKSHADWEEP,2013,2,0,0,1,0,0,0,3,38000,39000,77000,10.5593,72.6358,35,S,0.00045454545454545455
LAKSHADWEEP,2014,1,0,0,1,2,0,0,4,39000,40000,79000,10.5593,72.6358,26,S,0.0003291139240506329
PUDUCHERRY,2001,9,3,1,35,27,3,0,78,487000,487000,974000,11.93499371,79.83000037,445,S,0.0004568788501026694
PUDUCHERRY,2002,6,6,5,59,26,9,0,111,484000,489000,973000,11.93499371,79.83000037,625,S,0.0006423432682425488
PUDUCHERRY,2003,2,13,1,56,27,4,0,103,492000,498000,990000,11.93499371,79.83000037,548,S,0.0005535353535353535
PUDUCHERRY,2004,4,8,6,50,30,2,0,100,507000,512000,1019000,11.93499371,79.83000037,576,S,0.0005652600588812561
PUDUCHERRY,2005,6,3,4,60,26,6,0,105,527000,529000,1056000,11.93499371,79.83000037,576,S,0.0005454545454545455
PUDUCHERRY,2006,9,13,3,56,39,19,0,139,551000,547000,1098000,11.93499371,79.83000037,764,S,0.0006958105646630236
PUDUCHERRY,2007,9,14,2,89,32,17,0,163,579000,567000,1146000,11.93499371,79.83000037,897,S,0.0007827225130890052
PUDUCHERRY,2008,8,9,2,65,21,12,0,117,613000,590000,1203000,11.93499371,79.83000037,664,S,0.0005519534497090607
PUDUCHERRY,2009,1,13,0,53,16,10,0,93,651000,615000,1266000,11.93499371,79.83000037,488,S,0.00038546603475513426
PUDUCHERRY,2010,3,14,1,46,22,7,0,93,691000,640000,1331000,11.93499371,79.83000037,517,S,0.0003884297520661157
PUDUCHERRY,2011,7,9,1,35,16,10,0,78,730000,661000,1391000,11.93499371,79.83000037,463,S,0.00033285406182602444
PUDUCHERRY,2012,13,16,0,9,2,6,0,46,770000,681000,1451000,11.93499371,79.83000037,424,S,0.00029221226740179187
PUDUCHERRY,2013,17,25,1,12,8,8,0,71,812000,701000,1513000,11.93499371,79.83000037,628,S,0.00041506939854593525
PUDUCHERRY,2014,10,7,1,32,8,4,0,62,854000,719000,1573000,11.93499371,79.83000037,431,S,0.0002739987285441831
INDIA,2001,15694,13681,6738,33622,9656,49032,114,128537,532157000,496454000,1028611000,20.5937,78.9629,818604,ALL,0.0007958343824827851
INDIA,2002,15970,13613,6687,33497,10027,49102,76,128972,540936000,504611000,1045547000,20.5937,78.9629,821617,ALL,0.0007858250274736573
INDIA,2003,15357,12499,6078,32450,12220,49492,46,128142,549671000,512716000,1062387000,20.5937,78.9629,794361,ALL,0.0007477134038726001
INDIA,2004,17682,14697,6900,33966,9871,56867,89,140072,558354000,520763000,1079117000,20.5937,78.9629,886634,ALL,0.0008216291653268367
INDIA,2005,17701,14644,6673,33413,9759,56995,148,139333,566976000,528746000,1095722000,20.5937,78.9629,880857,ALL,0.000803905552685809
INDIA,2006,18725,16348,7481,35899,9822,61400,67,149742,575529000,536657000,1112186000,20.5937,78.9629,950401,ALL,0.000854534223592097
INDIA,2007,20139,19249,7955,37866,10783,74143,61,170196,584019000,544501000,1128520000,20.5937,78.9629,1058618,ALL,0.0009380586963456562
INDIA,2008,21001,21803,8043,39802,12084,79957,67,182757,592451000,552283000,1144734000,20.5937,78.9629,1129493,ALL,0.0009866859899330324
INDIA,2009,20928,24086,8242,38159,10891,88263,48,190617,600816000,559958500,1160737500,20.5937,78.9629,1167147,ALL,0.0007828929584059168
INDIA,2010,21665,28055,8248,40012,9881,92637,36,200534,609107000,567634000,1176741000,20.5937,78.9629,1237219,ALL,0.0010513944869771682
INDIA,2011,23634,33480,8476,42311,8408,97560,80,213949,617316000,575191000,1192507000,20.5937,78.9629,1346709,ALL,0.001129309094202382
INDIA,2012,24217,36102,8099,44624,8965,104542,59,226608,625446000,582670000,1208116000,20.5937,78.9629,1409991,ALL,0.0011670990202927534
INDIA,2013,32071,48272,7939,67224,11673,115833,31,283043,633505000,590076000,1223581000,20.5937,78.9629,1801818,ALL,0.00147257762256851
INDIA,2014,34639,53277,8302,77913,8374,119704,13,302222,641484000,597403000,1238887000,20.5937,78.9629,1950814,ALL,0.0015746504725612587
